CASSYRTGELFF	KRWIILGLNK
CASSSHERQGQNSPLHF	TPRVTGGGAM
CASTNRQEGQETQYF	KLVALGINAV
CASSLDLGDRGGYGYTF	ATDALMTGY
CASSQETGASGTQYF	RPPIFIRRL
CASSSTGPGNSPLHF	RAKFKQLL
CASSEARWVAGVWTGELFF	SLYNTVATL
CASRTTSGGASEQFF	YVLDHLIVV
CASSGGLPEGYTF	KRWIILGLNK
CASSTSYGYTF	KAFSPEVIPMF
CASIPEGGRETQYF	GLCTLVAML
CASSFHPGQGASYSNQPQHF	FLKEKGGL
CASSFGQQETQYF	GLCTLVAML
CASRTPGVSTEAFF	EPLPQGQLTAY
CASSLVGEGLRDEQFF	TPRVTGGGAM
CASSSGTVNTGELFF	ATDALMTGY
CSVGGTFYGYTF	GLCTLVAML
CASSLESGSSYNEQFF	GPGHKARVL
CASSQDRATQETQYF	TPGPGVRYPL
CASSPLGDRETQYF	KRWIILGLNK
CASSDDRGPYEQYF	KLVALGINAV
CASSLRPQLGETQYF	ATDALMTGY
CASEDSSDGANYGYTF	KAFSPEVIPMF
CASTRPGQGTYNEFQ	FLKEKGGL
CASSAGQGWKEQYF	ISPRTLNAW
CASSQTTSVNTEAFF	RAKFKQLL
CASSQAQGMGNSPLHF	RAKFKQLL
CASSPFQRSSGNTIYF	YVLDHLIVV
CASRSAQRGFTETQYF	NLVPMVATV
CASSELGARVYEQYF	FLKEKGGL
CSVEERVWGGEQYF	TPRVTGGGAM
CASSVGELAGGIDTQYF	GLCTLVAML
CASSPRRYNEQFF	HPVGEADYFEY
CASSPTGQLETQYF	ATDALMTGY
CASSVDKGGADTQYF	IIKDYGKQM
CASSTGQVSPGELFF	GLCTLVAML
CASSEGRISPGELFF	GLCTLVAML
CASSQDGVYTQYF	GPGHKARVL
CASSDRQNSPLHF	KRWIILGLNK
CATTVGVIGNQPQHF	ATDALMTGY
CASSYSTHYSLESDTQYF	SLYNTVATL
CASSSDPSGSIAYEQYF	RAKFKQLL
CASRSGTSNTGELFF	ATDALMTGY
CASSLVGTGGSYEQYFGP	NLVPMVATV
CASSYWQGELFF	KLVALGINAV
CASSLGQGLANYGYTF	FLKEKGGL
CASSEASGGFYNEQFF	IVTDFSVIK
CASRTGTSNTGELFF	ATDALMTGY
CASSLVGQLYEQYF	ATDALMTGY
CSVGGAYEQYF	RPPIFIRRL
CASSGQGGYTF	KAFSPEVIPMF
CASSLLVSGNEQFF	KRWIILGLNK
CSARGGTGNGYTF	GLCTLVAML
CASSPGQFSHEAFF	KRWIILGLNK
CASSVATVMTGELFF	ATDALMTGY
CASSSGTIGANVLTF	ATDALMTGY
CATATGTGSNTEAFF	RPPIFIRRL
CAGPQGRETQYF	YVLDHLIVV
CASSSLNTEAFF	RAKFKQLL
CASSYVGQLDEQFF	ATDALMTGY
CASSLEREGRGEQFF	KLVALGINAV
CASGQSGTAYNEQFF	KRWIILGLNK
CSATSRQGGREQYF	HPKVSSEVHI
CATSREPGSIVNEQFF	GPGHKARVL
CASSSRQNYGYTF	KAFSPEVIPMF
CASSKQSGTGYYGYTF	NLVPMVATV
CASSARTGELFF	HPVGEADYFEY
CSASDNELPGSSYNEQFF	KRWIILGLNK
CASSLGTSSYEQYF	KRWIIMGLNK
CASSGTASFDEQFF	KAFSPEVIPMF
CASSFSKNTEAFF	TPQDLNTML
CSTGSGEGYEQYF	RAKFKQLL
CASSSSSGASYNEQFF	RAKFKQLL
CASSQVGQNLYEQYF	KLVALGINAV
CSARDRTGNGYTF	GLCTLVAML
CASTQSPLAGNEQYF	KLVALGINAV
CASSEVGATNYGYTF	NLVPMVATV
CASSLLTGHEQFF	RAKFKQLL
CASSLALGVAKNIQYF	TPRVTGGGAM
CASPHPDRPNYGYTF	KAFSPEVIPMF
CASSLAETSADGYTF	KAFSPEVIPMF
CASSRGTSDYEQYF	KRWIIMGLNK
CSARDWTGNGYTF	GLCTLVAML
CASSLTTGIQYF	YVLDHLIVV
CASSLPGTSGISQDTQYF	RAKFKQLL
CASSPLTGTGHYGYTF	NLVPMVATV
CASSLTAGNNYGYTF	RAKFKQLL
CASRTGISNTGELFF	ATDALMTGY
CASSLTEAGNQPHQF	RAKFKQLL
CASSLYSGGGQPQHF	FPRPWLHGL
CASSDGKIAPSEQYF	GLCTLVAML
CASSSGLVAPGELFF	GLCTLVAML
CASSYLGDSTNSPLHF	RAKFKQLL
CSARDRVGNGYTF	GLCTLVAML
CASREDGASGSPDTQYF	KLVALGINAV
CAISDPGDTQYF	RPRGEVRFL
CSARSGTGGDYTF	GLCTLVAML
CASRAGTSNTGELFF	ATDALMTGY
CASSSASYGYTFGS	NLVPMVATV
CASSVVGGVDEQFF	ATDALMTGY
CASSFRGEGSYEQYF	RAKFKQLL
CASSGQGYGYTF	KAFSPEVIPMF
CASSLTLAGGIGTDTQYF	CINGVCWTV
CAIGDDRAGNQPQHF	ATDALMTGY
CATRSTDTQYF	GPGHKARVL
CASSSPASSTDTQYF	ATDALMTGY
CAISESTVGNQPQHF	ATDALMTGY
CASREGEYYGYTF	NLVPMVATV
CASSEILGMNTEAFF	RPPIFIRRL
CASSGGRDRSHEQYF	KRWIIMGLNK
CASRTGAANIYEQYF	TPRVTGGGAM
CASSQEGQLSYEQYF	RAKFKQLL
CASLFTGTSPTDTQYF	RAKFKQLL
CASSIRHSEYTDTQYF	ATDALMTGY
CASSSLVNTGELFF	KAFSPEVIPMF
CASSMTYGYTF	KAFSPEVIPMF
CASSEGRVLSGELFF	GLCTLVAML
CASSYAQGNEQFF	KLVALGINAV
CASSDLNSPLHF	RAKFKQLL
CASSLDRDRGRPEAFF	NLVPMVATV
CATTQYGTDTQYF	RAKFKQLL
CASTGSYGYTF	KAFSPEVIPMF
CASSVVGGRYGYTFGS	NLVPMVATV
CSARDGLGLAYEQYF	IVTDFSVIK
CASSLQTGAGGFGYTF	NLVPMVATV
CASTQGSTDTQYF	KLVALGINAV
CASSYNIAGELFF	KLVALGINAV
CASSLLAGGWDEQFF	ATDALMTGY
CASSQETPRGPPLAKNIQYF	KAFSPEVIPMF
CASELSGNTIYF	KAFSPEVIPMF
CASSDRQNTEAFF	KRWIILGLNK
CSARVPDSNTGELFF	CVNGSCFTV
CASSMGGEQYF	KLVALGINAV
CASSIRDAGNQPQHF	ATDALMTGY
CASTYDRGFTGELFF	ISPRTLNAW
CASRPDSDYGYTF	GLCTLVAML
CASSSVGPGDQPPAF	RAKFKQLL
CASSLSASTARYGYTF	TPRVTGGGAM
CASKQEWGNTEAFF	TPRVTGGGAM
CSARDVVDGNTGELFF	FLKEKGGL
CASSPSKPGDNEQFF	RAKFKQLL
CASSLGSGNYGYTF	IVTDFSVIK
CASSLVTGEGLGEQFF	RAKFKQLL
CASSVRTGELFF	HPVGEADYFEY
CASSLEGSYEQYF	KLVALGINAV
CASNPLSAGNQPQHF	CVNGSCFTV
CASSLIPGDYYGYTF	RAKFKQLL
CASEDFKNIQYF	KAFSPEVIPMF
CASSRSGLYEQYF	LPPIVAKEI
CAISESSSGNQPQHF	ATDALMTGY
CASSPRTLGTEAFF	FLRGRAYGL
CASSSAFYGYTF	NLVPMVATV
CAAADEEIGNQPQHF	ATDALMTGY
CATSTTFQTDYAEPYGYTF	CINGVCWTV
CASSLWSGASNEQFF	FPRPWLHGL
CASSPGQGVTPLHF	RAKFKQLL
CASREGDINTGELFF	IVTDFSVIK
CSLRSQGTDTQYF	NLVPMVATV
CASSLAGGQETQYF	KAFSPEVIPMF
CASSLIWDRGNYGYTF	KAFSPEVIPMF
CSAMAGGLRIYNEQFF	GLCTLVAML
CSARDRSLGNTIYF	GLCTLVAML
CASSLSTSSRNYGYTF	TPRVTGGGAM
CASSSTTGYTFGS	NLVPMVATV
CASSTGRVAPGELFF	GLCTLVAML
CASSPWTYGTGTLNEKLFF	ISPRTLNAW
CASSKWTGGNQWFF	GLCTLVAML
CASGRTGSEAFF	IPSINVHHY
CAISEGVSGGYNEQFF	ATDALMTGY
CASSWSASYEQYF	KLVALGINAV
CAISDQTSGNQPQHF	ATDALMTGY
CAISEDRALVSYTF	ATDALMTGY
CASSLTSEQFF	NLVPMVATV
CASRTLLGGASEQYF	YVLDHLIVV
CASSLIGAGGPDEQFF	TPRVTGGGAM
CASSLTTGYGYTF	ATDALMTGY
CASSRQGFT	KAFSPEVIPMF
CASSQSPGGTQYF	GLCTLVAML
CASSVELAGTYEQYF	KLVALGINAV
CASSLAVLSSYNEQFF	RAKFKQLL
CASSSLPGGTEAFF	NLVPMVATV
CATSIDRGREKLFF	KLVALGINAV
CASSLAPGATNEKLFF	NLVPMVATV
CASSFDSEAFF	SLYNTVATL
CASSAPTGELFF	HPVGEADYFEY
CASSPGLTYPGELFF	GLCTLVAML
CASSLTGPGDQPQHF	RAKFKQLL
CASIDRTIGNQPQHF	ATDALMTGY
CASTTEGGLIHEKLFF	YVLDHLIVV
CSVEGEEDANYEQYF	KRWIILGLNK
CASTGTDYGYTF	KAFSPEVIPMF
CASSLTAPDTDAFF	KAFSPEVIPMF
CASSSANYGYTF	NLVPMVATV
CASSLTGGGKLFF	TAFTIPSI
CQQLLFSGGGNEQFF	NLVPMVATV
CASTPVGHSNQPQHF	SLYNTVATL
CASSWLAGTREEQYF	RAKFKQLL
CSATDRDGGLEQYF	HPKVSSEVHI
CATSWTGTYEQYF	YVLDHLIVV
CASSLLIQGGENTEAFF	NLVPMVATV
CASSFYSSGRNSYF	NLVPMVATV
CASSKQGRGTDTQYF	RAKFKQLL
CSVGSTGGTNEKLFF	GLCTLVAML
CASSLWGGDFSQEQFF	FPRPWLHGL
CASSIVNEQFFGP	NLVPMVATV
CASSQGQFGNEQFF	KRWIILGLNK
CASSPDPGQLYEQYF	ATDALMTGY
CASSLRGTGELFF	FLKEKGGL
CSARDSTGNGYTF	GLCTLVAML
CASRTGQGAYEQYF	KRWIILGLNK
CAISDAGAGNQPQHF	ATDALMTGY
CASSLIRGTGELFF	RAKFKQLL
CSVGSAGTNEKLFF	GLCTLVAML
CSVPFEGGTLETQYF	GLCTLVAML
CASSQSPGGIAFF	GLCTLVAML
CASSYRGSGNTIYF	KLVALGINAV
CASSPSAAAYEQYF	FLRGRAYGL
CASRTGAANIYEQHF	TPRVTGGGAM
CASSADSNGELFF	IPSINVHHY
CASSLRGGGASYNEQFF	ISPRTLNAW
CASTPDLSSYNEQFF	ATDALMTGY
CASSLAQGWKTQYF	ISPRTLNAW
CASSYPFGGAWDEQFF	IPSINVHHY
CASSFGTGGEQYF	KRWIIMGLNK
CASSPGQYSHEQYF	KRWIILGLNK
CASSPGAGLYNEQFF	YVLDHLIVV
CASSSLTGTGYNEQFFGP	NLVPMVATV
CASSHLLGVLAGGTDTQYF	ATDALMTGY
CATSSGDLSSGANVLTF	KLVALGINAV
CASRALRGDNEQFF	NLVPMVATV
CAISGMGQRDNEQFF	HSKKKCDEL
CASSELAGVGETQYF	RAKFKQLL
CASSPIQGSEQYF	LPPIVAKEI
CASSLGPLTGLGPEAFF	HPKVSSEVHI
CASSLGQAYEQYF	FLRGRAYGL
CASSPTGTSHTGELFF	VSFIEFVGW
CASRDYEQYF	GPGHKARVL
CASSIFPGGGYGYTF	SLYNTVATL
CASSQRLAGAHEQYF	TPRVTGGGAM
CASSLLGGNPTQYF	KRWIIMGLNK
CASSLDSYEQYF	KRWIILGLNK
CASSSRQGGTGELFF	HSKKKCDEL
CASSPRGGGETQYF	TPGPGVRYPL
CASRQPGGVNEQFF	EPLPQGQLTAY
CASTTGTIGNQPQHF	ATDALMTGY
CASSLDVDSYNEQFFGP	NLVPMVATV
CASSRTSGGFYNEQFF	IVTDFSVIK
CASSMGANEQFF	KLVALGINAV
CASSLVLSSPTYEQYF	RAKFKQLL
CSVIGGFGTGELFF	TPRVTGGGAM
CASSELGRFIIQPQHF	GLCTLVAML
CASSYSTGTPGIYTF	NLVPMVATV
CASSANLAGDYNEQFFGP	NLVPMVATV
CASSEYPGPGANVLTF	ATDALMTGY
CASSLLEHNNGELFF	KRWIIMGLNK
CASSQGPGQEHYGYTF	VSFIEFVGW
CAISDFDRAGTQYF	QVPLRPMTYK
CASILRDFSSGNTIYF	ATDALMTGY
CASTVQGRETQYF	YVLDHLIVV
CSVPGQVLETQYF	GLCTLVAML
CASSIAGGGEDTQYF	KRWIILGLNK
CASRQGAGGNQPQHF	TPRVTGGGAM
CSAPGQEISTEAFF	GLCTLVAML
CSTGQGPYEQYF	RAKFKQLL
CSATNRDRGLEQYF	HPKVSSEVHI
CASSLLPYNALVSGTDTQYF	TPRVTGGGAM
CSARTSGDFGEQFF	CVNGSCFTV
CASSFIPGQGTHYSNQPQHF	FLKEKGGL
CASSRLDRDSYEQYF	RAKFKQLL
CASSRADLSYEQYF	KRWIILGLNK
CASSAGTINTGELFF	ATDALMTGY
CASSPLGGHHSGANVLTF	KRWIILGLNK
CASSVGLPYEQYF	NLVPMVATV
CASSSGATGANVLTF	ATDALMTGY
CACLLPYEQYF	GPGHKARVL
CASSEDKGGGDTQYF	IIKDYGKQM
CASRPQGRDNEQFF	RPRGEVRFL
CASSRKTGPYEQYF	KRWIILGLNK
CASSPITRIVGDTQYF	RAKFKQLL
CASSRQSGEREQFF	KRWIILGLNK
CAEGGRDYGYTF	KAFSPEVIPMF
CASSLAGDGANVLTF	GPGHKARVL
CASSQETSLYNEQFF	RPPIFIRRL
CASSFGQGEGYEQYF	RAKFKQLL
CASAPGLMSYEQYF	KRWIIMGLNK
CASQLYSGGDQPQHF	FPRPWLHGL
CASSSAFYGYTFGP	NLVPMVATV
CASSPADPFSNTQYF	KLVALGINAV
CASSMLLGGGQPQHF	YVLDHLIVV
CASSQESGTEAFF	CINGVCWTV
CASSLGGSPNYGYTF	TPRVTGGGAM
CASSLYTSNNEQFF	QVPLRPMTYK
CASSLEAGATYNEQFF	GPGHKARVL
CASSSSSQEQFF	KRWIILGLNK
CASSPGQVTPLHF	RAKFKQLL
CASGQGNFDIQYF	FLRGRAYGL
CASSDLANEQFF	YVLDHLIVV
CASSVSTGEAYGYTF	GPGHKARVL
CASSSFGPSNQPQHF	KRWIIMGLNK
CASSEGNGGINIQYF	ATDALMTGY
CASSLRQGGLTEAFF	ATDALMTGY
CASRLIGGGTEAFF	RPRGEVRFL
CASSLTAPDTEAFF	KRWIILGLNK
CASRALDITLGNVLTF	ATDALMTGY
CSVGSGGTNEKLFF	GLCTLVAML
CASSSTPLSTDTQYF	RPRGEVRFL
CASSQIVTSAAQYF	RAKFKQLL
CASSFDAEAFF	SLYNTVATL
CSVGSEGTNEKLFF	GLCTLVAML
CSARLGVGNTIYF	GLCTLVAML
CASSAWDINTGELFF	IVTDFSVIK
CASRASTGSGNTIYF	TPQDLNTML
CAWSSRDSMTDTQYF	NLVPMVATV
CASRPPDTGELFF	HPKVSSEVHI
CASSEPALAEQYYEQYF	FLKEKGGL
CASSPTVAGEQFF	CVNGSCFTV
CASSYTGELFF	KLVALGINAV
CASSLPGGAQGYTF	EPLPQGQLTAY
CASSLTGAGDQPQHF	RAKFKQLL
CASRTSGGHEQFF	IIKDYGKQM
CASSSPGASTYEQYF	KLVALGINAV
CASSARQGSRTDTQYF	ISPRTLNAW
CASSWTGPPGEQFF	LPPIVAKEI
CATSGTDRGGGETQYF	SLYNTVATL
CASSLMGNSPLHF	RAKFKQLL
CSARAGLNNEQFF	KRWIIMGLNK
CASSERRYTGELFF	ATDALMTGY
CASSLALRGGDQETQYF	IIKDYGKQM
CASSRELSMGETQYF	IPSINVHHY
CASSGTTSFDEQFF	KAFSPEVIPMF
CASSSLRGTAADTQYF	IIKDYGKQM
CASSHWDRETSGNTIYF	NLVPMVATV
CASNLGGPQQPQHF	SLYNTVATL
CASSFANYGYTFGS	NLVPMVATV
CASRGGTINTGELFF	ATDALMTGY
CASSQDPFAVLNTEAFF	NLVPMVATV
CASSLAQSREQYF	LPPIVAKEI
CASSFSRDSDEQFF	GLCTLVAML
CASRPPGGNEQFF	EPLPQGQLTAY
CASSFRGQQNNEQFF	GPGHKARVL
CASSELGATIYEQYF	FLKEKGGL
CASSYQTGTIYGYTF	NLVPMVATV
CASRSGDTNTGELFF	ATDALMTGY
CSVPGLAQNEQFF	KRWIILGLNK
CASSAYRGQANEQFF	QVPLRPMTYK
CASSHRQGGTGELFF	HSKKKCDEL
CSARDRVGNTIYF	GLCTLVAML
CASTEYSGSIEQFF	KRWIILGLNK
CASSVGGPYTGELFFGE	NLVPMVATV
CASSLARGFSDHTQYF	TPRVTGGGAM
CASSLGRGQFF	KLVALGINAV
CASSSRGQLDTQYF	ATDALMTGY
CAISAGASFVTRSTDTQYF	QVPLRPMTYK
CATLISQGSRAGELFF	VSFIEFVGW
CASSLRNSYEQFF	GLCTLVAML
CASSPYSGSYEQYF	KRWIILGLNK
CASSLYGEYEQYF	KRWIILGLNK
CSVRGEGDTQYF	GLCTLVAML
CASSSVNGAFFGQ	NLVPMVATV
CASSSHDKQGARSPLHF	TPRVTGGGAM
CASSEVGLLNEQFF	ATDALMTGY
CASSPSGTPYEQYF	GPGHKARVL
CASSPVTGGIYGYTGF	NLVPMVATV
CASSLWSGIADTQYF	FPRPWLHGL
CASSGVGYQPQHF	SLYNTVATL
CSARVRAGSYNEQFF	QVPLRPMTYK
CASSQDEPSEQYF	GPGHKARVL
CASSLGPGNYEQYF	TPRVTGGGAM
CASSIDGTAYEQYF	GLCTLVAML
CASSSPGDYTYEQYF	YVLDHLIVV
CASSLLGTENTEAFF	RAKFKQLL
CASSFGADTQYF	KLVALGINAV
CASSPGTSGGGDEETQYF	RAKFKQLL
CASRMQGRDNEQFF	RPRGEVRFL
CASNRGDGYTF	KLVALGINAV
CASRRQGRDNEQFF	RPRGEVRFL
CASSLYGSPDQPQHF	FPRPWLHGL
CASSLTGGGELFF	TAFTIPSI
CASSTPGGGQDTQYF	KRWIIMGLNK
CASSPISISSGLPEYF	ATDALMTGY
CASSYATGASYGYTF	NLVPMVATV
CASRVGTGNLYEQYF	TPRVTGGGAM
CAWDVKDRRIGNEQFF	FLKEKGGL
CASSQVRGGYEQFF	RAKFKQLL
CASSRRGAATSTDTQYF	HSKKKCDEL
CASSLTVAGDTEAFF	RAKFKQLL
CASSPPSGSGFNEQFF	GLCTLVAML
CASSLWGGPTNEQYF	FPRPWLHGL
CASSQSTGELFF	KRWIILGLNK
CASSAPSGEQFF	HPVGEADYFEY
CASSSMVAGEYEQFF	RAKFKQLL
CASSLIYRGGDGYTF	GPGHKARVL
CASTSAGTPDNEQFF	RAKFKQLL
CASSIETSPGDTQYF	GPGHKARVL
CASSLGTGPSYEQYF	ATDALMTGY
CASSPSGTPYERYF	GPGHKARVL
CASNPGTSNEQFF	GLCTLVAML
CASSYSRGSGNTIYF	QVPLRPMTYK
CASSGQDYGYTF	KAFSPEVIPMF
CASSLRGLAFTSSYNEQFF	KRWIILGLNK
CASSPSTANTQPQHF	ATDALMTGY
CSARDQTGNGYTF	GLCTLVAML
CSVGAGDYEQYF	RAKFKQLL
CASSPQTGAIYGYTF	NLVPMVATV
CASRLGPGQPYEQYF	TPRVTGGGAM
CASSLDRETGY	KRWIILGLNK
CASSLGANTIYF	TPQDLNTML
CASSRRGATTSTDTQYF	HSKKKCDEL
CASSLSAGQGMTDTQYF	KRWIILGLNK
CASSEGDTEAFF	KLVALGINAV
CASSSGVTNTGELFF	ATDALMTGY
CASSFRQGLGHTGELFF	FPRPWLHGL
CASLRGLGTDTQYF	RAKFKQLL
CASSAPDSQETQYF	KAFSPEVIPMF
CASSPLGHRDTEAFF	VSFIEFVGW
CSAKILAGAGSEQYF	NLVPMVATV
CASSVDKGGTDTQYF	IIKDYGKQM
CASSSTGYVNEQYF	GPGHKARVL
CASSLIGVGLTDTQYF	TPRVTGGGAM
CASSQGLAEWDEQFF	IPSINVHHY
CASSEAAGGFYNEQFF	IVTDFSVIK
CASSRSLNVNSNQPQHF	KLVALGINAV
CASSSGRGGEQYF	TAFTIPSI
CASRSGTYDNSPLHF	NLVPMVATV
CASSESMIQHF	NLVPMVATV
CATGTGDSNQPQHF	EPLPQGQLTAY
CSVEEGVLYEQYF	IPSINVHHY
CSVGSSGTNEKLFF	GLCTLVAML
CASSLRGRGDQPQHF	HSKKKCDEL
CASSSHEDRGSSSPLHF	TPRVTGGGAM
CSVEPSGRARTYNEQFF	FLKEKGGL
CASSPTSGGNNEQFF	CVNGSCFTV
CASSPLTDTQYF	RAKFKQLL
CASSYSRGVGNTIYF	QVPLRPMTYK
CSGGQGEGEQYF	RAKFKQLL
CASSSRQGKEAFF	LPPIVAKEI
CASSLKLADEQFF	ISPRTLNAW
CASSLEGSYEQYF	RAKFKQLL
CASSAGRVSPGELFF	GLCTLVAML
CASRLLAGAYEQYF	CINGVCWTV
CASSCQTGAACGYTF	NLVPMVATV
CASSQAREQFF	KRWIILGLNK
CASRGADTGELFF	HPKVSSEVHI
CSARQGLNNEQFF	KRWIILGLNK
CSVSAGEEDTQYF	RAKFKQLL
CASSYRGLKEQYF	SLYNTVATL
CASSLRGGNTDTQYF	KRWIILGLNK
CASSFSGQLDTIYF	ATDALMTGY
CASSLYTGSDQPQHF	FPRPWLHGL
CASILERGSSYNEQFF	IPSINVHHY
CASSEYGAAVYEQYF	FLKEKGGL
CASMGGASYNEQFF	YVLDHLIVV
CASSLRQGANTGELFF	TPRVTGGGAM
CATSREGPNQPQHF	NLVPMVATV
CASSLGPAIPGNTIYF	HPKVSSEVHI
CASSLETGTEAFF	GPGHKARVL
CASSQWSNEKLFFGS	NLVPMVATV
CSARGEAITEKLFF	GLCTLVAML
CASRYTGQETYEQYF	RAKFKQLL
CASSLAQGQPQHF	KLVALGINAV
CASSIAEREAFF	GPGHKARVL
CASSLSPSTGNYGYTF	TPRVTGGGAM
CSARDEVGNTIYF	GLCTLVAML
CASSVRSGELFF	HPVGEADYFEY
CSVGTGGTNEKLFF	GLCTLVAML
CASSPSGANVLTF	RAKFKQLL
CASSLNGGHYEQYF	IVTDFSVIK
CASSLSWGGFYNEQFF	TPRVTGGGAM
CASSSSWGYGYTF	TPRVTGGGAM
CASSGRNEQFF	KAFSPEVIPMF
CASNILGQAIDTQYF	RAKFKQLL
CASRIWGGADTQYF	RPRGEVRFL
CASSLVTGTGKYGYTF	NLVPMVATV
CASSQETQYF	KLVALGINAV
CASSLGASTDTQYF	RPPIFIRRL
CASSWSGGQRGYTF	KAFSPEVIPMF
CASSLRGETQYF	GPGHKARVL
CASSWGQGQLSYEQYF	FLKEKGGL
CASSQGTGGGYGYTF	RAKFKQLL
CASSEWTVDGYTF	RPRGEVRFL
CASGLGPSGTEAFF	KRWIILGLNK
CASSSATYGYTFGS	NLVPMVATV
CASSVIGATYEQYF	RPRGEVRFL
CASDSNTEAFF	KLVALGINAV
CASVGGLALYNEQFF	GPGHKARVL
CASSQGFGGGETQYF	YVLDHLIVV
CASSEAGQLNEQFF	ATDALMTGY
CASSHGDYEQYF	KRWIILGLNK
CATSDLKVHSGNYGYTF	NLVPMVATV
CSARDRGLGNTIYF	GLCTLVAML
CASSQSPGGIQYF	GLCTLVAML
CASSLVGPPGEAFF	LPPIVAKEI
CASTDSYGYTF	KAFSPEVIPMF
CASSLNGADGYTF	TPQDLNTML
CASSIDYYSNQPQHF	NLVPMVATV
CASSQDRIHTEAFF	ISPRTLNAW
CSARPMAASGLTYEQYF	FLKEKGGL
CASSLRQGIDTGELFF	TPRVTGGGAM
CASSSKDGQSQYF	LPPIVAKEI
CASSLSRTGFYEQYF	HPKVSSEVHI
CASSTGGSGNFSYEQYF	ATDALMTGY
CASSSPHRDSYSPLHF	KLVALGINAV
CASSFLAGFTDTQYF	ATDALMTGY
CASSEQSGANVLTF	RAKFKQLL
CASSQAQSGTAPYEQYF	CINGVCWTV
CASSAVAGAPLEQYF	NLVPMVATV
CASSLIGGRNGYTFGQ	NLVPMVATV
CASSILAGLNEQYF	GPGHKARVL
CASSLYSDTQYF	YVLDHLIVV
CAWNRGMNTEAFF	GPGHKARVL
CASGGEFYGYTF	KAFSPEVIPMF
CSARVEPGNGYTF	GLCTLVAML
CASRGLAGGLGELFF	NLVPMVATV
CSARSETGNTIYF	GLCTLVAML
CASSVLAGDTQYF	RAKFKQLL
CASSPREIGNQPQHF	ATDALMTGY
CASSQAGLAAYNEQFF	GLCTLVAML
CSARIGVGNTIYF	GLCTLVAML
CASSPTSGEYNEQFF	RAKFKQLL
CASTASYGYTF	KAFSPEVIPMF
CASSQGQYSHEQYF	KRWIILGLNK
CASSGTSYGYTF	KAFSPEVIPMF
CASSLAPGTTNEKLFF	NLVPMVATV
CASSPYAGSEQFF	KAFSPEVIPMF
CASSSLGQLETQYF	ATDALMTGY
CASGGGGFQETQYF	GLCTLVAML
CASSLMASGGYNEQFF	RAKFKQLL
CASSPRGTRTDTQYF	TPGPGVRYPL
CSVWGTGKTYEQYF	FLKEKGGL
CASSYPRGGEGSPLHF	RAKFKQLL
CSARDRTGNTIYF	GLCTLVAML
CSARDRIGNGYTF	GLCTLVAML
CATSREEPIQPGEQFF	GPGHKARVL
CASSRGQGSADTQYF	YVLDHLIVV
CARSRGGINTGELFF	ATDALMTGY
CATTGSYGYTF	KAFSPEVIPMF
CASSMIGHSNQPQHF	SLYNTVATL
CASMNDGATYEQYF	NLVPMVATV
CASSLPGRDEQYF	EPLPQGQLTAY
CASSGREHEQYF	HPVGEADYFEY
CASSDPDLLISTDTQYF	ATDALMTGY
CASSHRTGELFF	KRWIILGLNK
CASTGGSYGYTF	KAFSPEVIPMF
CASSPKLQGAWAEKLFF	NLVPMVATV
CASSLAVEGVSRMNTEAFF	YVLDHLIVV
CASMGGANTEAFF	KRWIILGLNK
CASSVEGIDEKLFF	KLVALGINAV
CSTQEGGYGYTF	GLCTLVAML
CAIGGHDYGYTF	KAFSPEVIPMF
CASSPRQGGTGELFF	HSKKKCDEL
CSARPTSNYEQFF	YVLDHLIVV
CSARDPSRGSGVMDEQFF	KRWIILGLNK
CASRGGQGSTEAFF	KRWIIMGLNK
CASTPQTGTGTYGYTF	NLVPMVATV
CASTPAGGAPGELFF	NLVPMVATV
CAISEVQETQYF	HSKKKCDEL
CSARGEGGSYNEQFF	VSFIEFVGW
CASSVGSEAYTYEQYF	NLVPMVATV
CASSGFRDRVNEQYF	KAFSPEVIPMF
CASSLSDRGGDEQFF	NLVPMVATV
CASSLLQGARTEAFF	TPRVTGGGAM
CASSSSSAPNEKLFF	IPSINVHHY
CASSVQALLAGDWADTQYF	RPRGEVRFL
CASSMGTGAHEQYF	ATDALMTGY
CASREGLGGTEAFF	KRWIIMGLNK
CASSELGGAGTGELFF	NLVPMVATV
CASSLAGGSYNSPLHF	IVTDFSVIK
CASSLRGESLVNEQFF	TPRVTGGGAM
CASTSGNTGELFF	CVNGSCFTV
CASSAGTGIYDEAFF	TPRVTGGGAM
CASSSHDLAGVKSEQFF	TPRVTGGGAM
CASSLGLEPQHF	GPGHKARVL
CSVGAGEGGPQHF	RAKFKQLL
CASSSSISGMRPRIYEQYF	ATDALMTGY
CATEASGNTIYF	KAFSPEVIPMF
CSVEGMRDYGYTF	IIKDYGKQM
CSVGGTLDTQYF	NLVPMVATV
CSVDLANTEAFF	GLCTLVAML
CASSLDVNEQFF	KRWIILGLNK
CASRLQGINEKLFF	RPRGEVRFL
CASGGRGGGETQYF	ATDALMTGY
CASSRPGQGGYEQYF	NLVPMVATV
CASSLSGQLDTQYF	ATDALMTGY
CASSGGTASTDTQYF	ATDALMTGY
CASSLLIGANNEQFF	RAKFKQLL
CASRIPGGINEQYF	EPLPQGQLTAY
CSVDLGVAGGPNTGELFF	GPGHKARVL
CASSYSTGVPGELFF	NLVPMVATV
CASSSATGITGELFF	ISPRTLNAW
CASSIVGAHTEAFF	IVTDFSVIK
CASTGGGYGYTF	KAFSPEVIPMF
CASSLGPTEAFF	TPQDLNTML
CASSQVLAPIQYF	GPGHKARVL
CASSSVNEQFF	NLVPMVATV
CSANDRSYNEQFF	YVLDHLIVV
CASSPGDTGANVLTF	ATDALMTGY
CASSLEGYTEAFF	NLVPMVATV
CASRRQRTDTEAFF	TPRVTGGGAM
CASSLSQGIQNIQYF	RPPIFIRRL
CASSFEAGQGFFSNQPQHF	FLKEKGGL
CASSQETGSASQHF	RPPIFIRRL
CASSSHDRQGQNSPLHF	TPRVTGGGAM
CASSVAGGDEQFF	GLCTLVAML
CSVGMDGVTNEKLFF	GLCTLVAML
CSARDRGAENTGELFF	RAKFKQLL
CASSQLGQSETQYF	RAKFKQLL
CASSTGTVYNEQFF	KRWIILGLNK
CASSLEPGTSSYNEQFF	KRWIILGLNK
CASSSHVINQFF	RAKFKQLL
CASSSNRDRNTIYF	RAKFKQLL
CASTGTAYGYTF	KAFSPEVIPMF
CASSSPSGRPTLYNEQFF	CINGVCWTV
CASSYQSGNTEAFF	KLVALGINAV
CASSLGSSGNEQFF	TPRVTGGGAM
CASSVGDWAQGNTIYF	IVTDFSVIK
CASSFGQAWYEQYF	NLVPMVATV
CASYWGLAVNEQFF	RPPIFIRRL
CASSSWEGLDTQYF	KAFSPEVIPMF
CASGAAMNTEAFF	HPKVSSEVHI
CASSYSGGVFEQFF	RAKFKQLL
CASSSRHEGEDTEAFF	KLVALGINAV
CASNRENEKLFF	CINGVCWTV
CSATSRDSALEQYF	HPKVSSEVHI
CASTTGSSEKLFF	CINGVCWTV
CASSLSTAEAFFGQ	NLVPMVATV
CASSLTLGLAGVETQYF	CINGVCWTV
CAISESTAGNNEQFF	ATDALMTGY
CASSQGTTDTQYF	KRWIILGLNK
CASRDPGLAGEGHGELFF	RAKFKQLL
CAISESDPLRGTEAFF	HPVGEADYFEY
CASSSAFYGYTFGS	NLVPMVATV
CSATILAGVPYGEQYF	FLKEKGGL
CASSDHSVTGISSPLHF	TPRVTGGGAM
CASSLRGGNTDTQYF	KRWIIMGLNK
CASSLTGTGFKQFF	CINGVCWTV
CASSHGMGASTSGYTF	LPPIVAKEI
CATTDTYGYTF	KAFSPEVIPMF
CASSLTGQETQYFGP	NLVPMVATV
CASSLVDPTGFGLETQYF	IIKDYGKQM
CASSFTTMGNQPQHF	ATDALMTGY
CASSYRGQLNEQFF	ATDALMTGY
CASSGDRDAGSSYEQYF	ATDALMTGY
CASSPRQGHEQYF	LPPIVAKEI
CASSPSLVGSADTQYF	YVLDHLIVV
CASSLELAMGETQYF	IPSINVHHY
CASSEALLGRANYGYTF	NLVPMVATV
CSVGADGTNEKLFF	GLCTLVAML
CASSLLGQDNSPLHF	RAKFKQLL
CSATSRDGDNEQFF	HPKVSSEVHI
CASSPPLGLHTGELFF	YVLDHLIVV
CSARDRGAANTGELFF	RAKFKQLL
CASNPSGGYTGELFF	NLVPMVATV
CASSPRRYNLQFF	HPVGEADYFEY
CASSSHVGGGGASIDTQYF	ATDALMTGY
CSASNPLLGQGAGYGYTF	KRWIILGLNK
CASSEVTGTAWGYTF	NLVPMVATV
CASSLYSGGDKEQYF	FPRPWLHGL
CASSKGSVAPGELFF	GLCTLVAML
CASRKTGGGEAFF	RPRGEVRFL
CASSVEGGGAKETQYF	KLVALGINAV
CASSLGGGYTF	KAFSPEVIPMF
CASSQVRLNTEAFF	KLVALGINAV
CASSLGADQPQHF	HPKVSSEVHI
CASSALGGGGTGELFF	NLVPMVATV
CASSSFRDGGTDTQYF	HPKVSSEVHI
CASSPGSSFYGYPF	NLVPMVATV
CSAWDREVVGTEAFF	GLCTLVAML
CASSQSRGSGNTIYF	HSKKKCDEL
CASSPGGRQGDYNEQFF	RAKFKQLL
CAISTGDYEQYF	EPLPQGQLTAY
CASSQSIGGELFF	RAKFKQLL
CASSLGDSWNSPLHF	GPGHKARVL
CASSTGQAYEQYF	FLRGRAYGL
CASSLLGHPSGELFF	RAKFKQLL
CASSWGGGEQYF	KLVALGINAV
CASSLSVSTSLDTQYF	YVLDHLIVV
CASSVATLNTGELFF	ATDALMTGY
CASTSGQTFPGELFF	GLCTLVAML
CASSFRLGQGHYGYTF	YVLDHLIVV
CASSPGTGSYEQYF	RAKFKQLL
CSARDQRGLAGGIGDTQYF	NLVPMVATV
CASSLAPLAGGAFSYNEQFF	ATDALMTGY
CASSFQGYTEAFF	NLVPMVATV
CASSTDSVDEQFF	RPRGEVRFL
CASSPGNILYGYTFGS	NLVPMVATV
CASRQDRDYQETQYF	HPVGEADYFEY
CAQPVVYSYEQYF	GPGHKARVL
CASSSRDGQEQYF	LPPIVAKEI
CASSSVNEQYF	NLVPMVATV
CASSLGTSSSYEQYF	KRWIIMGLNK
CASSQDGAGGLGEQFF	GLCTLVAML
CASRPSGQLDEQFF	ATDALMTGY
CASKKSTGGNTDTQYF	KRWIILGLNK
CASSLGPRYEQYF	HPKVSSEVHI
CASSPGTGEGYEQYF	RAKFKQLL
CASSSVNEAFFGQ	NLVPMVATV
CASSLAERSYEQYF	NLVPMVATV
CASSSVNEQYFGP	NLVPMVATV
CAISESASGSNEQYF	ATDALMTGY
CASSPGQFSHEAFF	KRWIIMGLNK
CASSPTGGPGELFF	GPGHKARVL
CASSLNTGVKNIQYF	GPGHKARVL
CAISDSSSGSNEQFF	ATDALMTGY
CASSEGRVSPGELFF	GLCTLVAML
CSARDINPGLAYEQFF	KRWIILGLNK
CASSSHDRDGGYSPLHF	TPRVTGGGAM
CSARGLGVNTEAFF	LPPIVAKEI
CATSNLDSFGGYTF	CINGVCWTV
CASSLTSGSPYNEQFF	NLVPMVATV
CASSLGTGAPYEQYF	CINGVCWTV
CASSQKGLDTEAFF	TPRVTGGGAM
CASSLDPAGQGYEQYF	IPSINVHHY
CSARTLEGILTTGETQYF	KRWIILGLNK
CASSSVDEAFFGQ	NLVPMVATV
CASSIKGYNEQFF	FPRPWLHGL
CSAHLYRAYGYTF	FLKEKGGL
CASSDGAILPGELFF	GLCTLVAML
CSAPIPPYNEQFF	YVLDHLIVV
CALAVPYEQYF	GPGHKARVL
CASSPLIGTSGTEAFF	RAKFKQLL
CASYNFGQYGYTF	KAFSPEVIPMF
CASSIGQYEQYF	KLVALGINAV
CASRDILTSYNEQFF	ATDALMTGY
CAVRLMENYGYTF	HSKKKCDEL
CASRPGQGNNEQFF	KRWIILGLNK
CASSLRGVSSYNEQFF	TPRVTGGGAM
CASSQAGFNEQFF	FLRGRAYGL
CASSEDRNEQFF	KRWIILGLNK
CASSLDLSSGANVLTF	YVLDHLIVV
CASSSANYGYTFGQ	NLVPMVATV
CASSPVTGGIYGYTF	NLVPMVATV
CASSLTGGNTIYF	TAFTIPSI
CASSEGEGQGHYGYTF	VSFIEFVGW
CASSMADLSYEQYF	KRWIILGLNK
CSARSRVGNTIYF	GLCTLVAML
CASSLFTDRRDGYTF	IPSINVHHY
CASSGSYGYTF	KAFSPEVIPMF
CASNTGGANTDTQYF	TPRVTGGGAM
CSARDLGLAGDTDTQYF	KRWIILGLNK
CASSLPRGRDNEQFF	RAKFKQLL
CASSSGVSGANVLTF	ATDALMTGY
CAISGQAVSTDTQYF	KLVALGINAV
CAISESQGNTEAFF	ATDALMTGY
CASSLDSQSSGNTIYF	RAKFKQLL
CSAGTGEGGEQFF	RAKFKQLL
CASRGTGVHEQYF	IIKDYGKQM
CASSPSGQLDEQFF	ATDALMTGY
CASSQHDRGFSTEAFF	TPRVTGGGAM
CASSVASGTDTQYF	FLRGRAYGL
CASSPGQLGNTIYF	KRWIILGLNK
CASSTFGATQETQYF	TPGPGVRYPL
CASSPRTGELFF	KRWIILGLNK
CASSGSSGGYYNEQFF	IVTDFSVIK
CASSQVWGSGEKLFF	NLVPMVATV
CASSFEPGQGFYSNQPQHF	FLKEKGGL
CASSLNLRGSSGNTIYF	FLKEKGGL
CASSVAAGLSHEQFF	GPGHKARVL
CASSFTTLGEQYF	KRWIIMGLNK
CASSLGLAATYNEQFF	NLVPMVATV
CASRTGTINTGELFF	ATDALMTGY
CASSQGVGENTEAFF	RAKFKQLL
CASSYSTVNEQFF	TPRVTGGGAM
CASSLWAGGLYEQFF	RAKFKQLL
CASRTSGEETQYF	IIKDYGKQM
CASSLGTSSYEQYF	KRWIILGLNK
CASIPNLGNEQFF	LPPIVAKEI
CASRGLLGGITEAFF	YVLDHLIVV
CASSLAASVNPAYGQYF	NLVPMVATV
CASSRGDTEAFF	KLVALGINAV
CVSSLAGTQETQYF	KAFSPEVIPMF
CASRAGLAEVSYEQYF	RAKFKQLL
CASSLSTGAPYEQYF	CINGVCWTV
CASSVWGDPSYEQYF	TPGPGVRYPL
CATSPGQGFYNEQFF	CINGVCWTV
CSVGAGEGYEQYF	RAKFKQLL
CSVGFGEGYEQYF	RAKFKQLL
CSVPGTDYNEQFF	GLCTLVAML
CASSNRQGGTGELFF	HSKKKCDEL
CASSWGGGSNYGYTF	IVTDFSVIK
CASSLWGGSSNEQFF	FPRPWLHGL
CASSLSSPGNQPQHF	RAKFKQLL
CASSPWASGTQETQYF	RAKFKQLL
CASSLAAGLNLKNIQYF	GLCTLVAML
CASGDRQNSPLHF	KRWIILGLNK
CASSPGQGFKTQYF	KAFSPEVIPMF
CASSPGGELFF	KLVALGINAV
CASSEGQVSPGELFF	GLCTLVAML
CASRLGLGYEQYF	NLVPMVATV
CASSGQDSTQYF	GPGHKARVL
CAISERHLTDTQYF	HSKKKCDEL
CASSFGPSNQPQHF	KRWIILGLNK
CASSREVYGYTF	KAFSPEVIPMF
CASSLFTDNRDGYTF	IPSINVHHY
CATSDDRDTGELFF	TPRVTGGGAM
CSATDSMNTEAFF	GLCTLVAML
CASGTGESGYTF	RAKFKQLL
CASSFGTGGVGELFF	ISPRTLNAW
CASSVEAEGFGAPISPPEAFF	IPSINVHHY
CASSQEKGTEAFF	CINGVCWTV
CASSNSEGSGANVLTF	CVNGSCFTV
CASSLGEKLFF	KLVALGINAV
CSVGTATNEKLFF	GLCTLVAML
CASSDGTANNQPQHF	ATDALMTGY
CSARQEGGSYNEQFF	VSFIEFVGW
CAIRTRIGETQYF	HSKKKCDEL
CASSLGLGVNNEQFF	RAKFKQLL
CASSPLYVALREQYF	CVNGSCFTV
CASSQETGSYEQFF	RPPIFIRRL
CATLAGEGEQFF	RPPIFIRRL
CAIRSGTINTGELFF	ATDALMTGY
CASFLNTEAFF	ISPRTLNAW
CSARAGVGNTIYF	GLCTLVAML
CASSLQTGLNTEAFF	TPRVTGGGAM
CASSQDRGVLVLIDQPQHF	CVNGSCFTV
CASSLERSSEQYF	FPRPWLHGL
CASSGLNSPLHF	RAKFKQLL
CASSPQTGTIYGYTGF	NLVPMVATV
CASSHGQGMKTQYF	ISPRTLNAW
CASSLTEAGNQPHHF	RAKFKQLL
CASSQRQDSSYNEQFF	KAFSPEVIPMF
CASSYWTGSSAETQYF	CVNGSCFTV
CASSYMGVEQFF	YVLDHLIVV
CATSSFPRLEWDEQFF	RAKFKQLL
CASSLGRGSGANVLTF	SLYNTVATL
CASSYLPGQGDHYSNQPQHF	FLKEKGGL
CASSVVNEQFF	NLVPMVATV
CASSTTRAGDQPQHF	RAKFKQLL
CASSFDREVTGELFF	FLKEKGGL
CASSPVAGGAYNEQFF	NLVPMVATV
CASSSGMRGTEAFF	KRWIILGLNK
CASSSAYYGYTF	NLVPMVATV
CASSLGPAAGYTF	HPKVSSEVHI
CSVEDGYEQYF	CVNGSCFTV
CASSQAGQGNSPLHF	RAKFKQLL
CASSVSGGQVTDTQYF	TPGPGVRYPL
CASSVGAGVFTDTQYF	NLVPMVATV
CASSSTEQATYGYTF	RAKFKQLL
CASSETGATNYGYTGF	NLVPMVATV
CSVGQGEDGPQHF	RAKFKQLL
CASSMLGGGRDEQFF	VSFIEFVGW
CASSVRPGLAGGGTGELFF	HPVGEADYFEY
CATSETGELFF	KRWIILGLNK
CASNGQGARDGYTF	IPSINVHHY
CSVGAAGTNEKLFF	GLCTLVAML
CASSQEGGGQGQPQHF	TPQDLNTML
CASSYQTGASYGYTF	NLVPMVATV
CASSLWSGVGDGYTF	FPRPWLHGL
CASSDRSQYGYTF	KAFSPEVIPMF
CASSLGPPPDNEQFF	CINGVCWTV
CASKWDPGQGSHYSNQPQHF	FLKEKGGL
CASSLGRGSGANVPTF	SLYNTVATL
CASSGTDYGYTF	KAFSPEVIPMF
CASSLGLNTIYF	TPQDLNTML
CASSHSRDSYNEQFFGP	NLVPMVATV
CAISGEFGSGANVLTF	GLCTLVAML
CASRHQLAQSSYNEQFF	ATDALMTGY
CASSQTQLWETQYF	NLVPMVATV
CASRPYSGRAGAYTGELFF	SLYNTVATL
CASSPYPRGGTGELFF	KLVALGINAV
CSARVGVGNTIYF	GLCTLVAML
CASSIHSETGVGSPLHF	TPRVTGGGAM
CASSGSGTGYGYTF	KAFSPEVIPMF
CSARVGLNNEQFF	KRWIILGLNK
CASSPWGDGTDTQYF	KAFSPEVIPMF
CAISTGPDSYEQYF	EPLPQGQLTAY
CASSYATAYEQYF	IPSINVHHY
CASSPPGGRADTQYF	TAFTIPSI
CASKNRDVGYNEQFF	ATDALMTGY
CASSRQGGQTTDTQYF	TPGPGVRYPL
CASSVGQAYEQYF	FLRGRAYGL
CASSQDPSGNPMETQYF	ISPRTLNAW
CASSISSGITYEQFF	RPPIFIRRL
CSGGTDGTNEKLFF	GLCTLVAML
CASSQVQGTSGGEQYF	RAKFKQLL
CASSPPAGSYNEQFF	NLVPMVATV
CASSLGRDGVYF	RAKFKQLL
CASSASAGGYYNEQFF	IVTDFSVIK
CASSALASLNEQFF	FLKEKGGL
CSARGGERFYEQYF	KRWIIMGLNK
CASREGLGGTEAFF	KRWIILGLNK
CASTGTSGALYNEQFF	NLVPMVATV
CASSQSGQLDTQYF	ATDALMTGY
CASSRGTGEGYEQYF	RAKFKQLL
CASSAAGELETQYF	RPPIFIRRL
CATSDWAGEMETQYF	YVLDHLIVV
CASSFGGATGPGELFF	GPGHKARVL
CASTGGLGYTF	KLVALGINAV
CASQGGEIGNNEQFF	ATDALMTGY
CAISTGDSNQPQHF	EPLPQGQLTAY
CASSPTNPAGDTETQYF	RPPIFIRRL
CASSSILGQGEHPVTDTQYF	ATDALMTGY
CASSDRQSLVQFF	LPPIVAKEI
CASSPLPGTTGTDTQYF	YVLDHLIVV
CASSPTGGSPSPLHF	NLVPMVATV
CASSLGGLGDTQYF	RPRGEVRFL
CASSLIGRDEQFF	EPLPQGQLTAY
CASGYRDRGVAFF	GPGHKARVL
CASTNSGNTIYF	KLVALGINAV
CASSAFAGTGELFF	GPGHKARVL
CASSFVGEGYEQYF	RAKFKQLL
CASSDNPLVGGFTDTQYF	IIKDYGKQM
CSATDRASGIEQYF	HPKVSSEVHI
CASSPDRARDGYTF	KAFSPEVIPMF
CAIRTGGDEQFF	HSKKKCDEL
CASSSPGGRGNTEAFF	YVLDHLIVV
CAISEGTVGFDEQYF	ATDALMTGY
CASRTGQGAYEQYF	KRWIIMGLNK
CSARDATGNGYTF	GLCTLVAML
CASFRTGTSETQYF	GPGHKARVL
CASSRSTGELFF	KRWIILGLNK
CASSRLTVDRSDTGELFF	HSKKKCDEL
CASSGYTGELFF	KLVALGINAV
CASSSTGRDTDTQYF	RAKFKQLL
CASSLIGQGGPDTQYF	TPRVTGGGAM
CASSLLGGNPTQYF	KRWIILGLNK
CASSQGGQGAPYEQYF	CINGVCWTV
CASSFTWTSGGATDTQYF	FLRGRAYGL
CASSPYQTGLDGYTF	RPRGEVRFL
CSARPGQGTVALHF	KAFSPEVIPMF
CASSVAIWRGSYNEQFF	KLVALGINAV
CAISDPGTLPNYGYTF	HPVGEADYFEY
CASSSIATGANVLTF	ATDALMTGY
CASSLTGHPYEQYF	QVPLRPMTYK
CSVGQGGNYGYTF	RAKFKQLL
CSVVETVGETQYF	GPGHKARVL
CASSQSPGGFQYF	GLCTLVAML
CASSLSPPTYEQYF	TPRVTGGGAM
CASSLVGQLETQYF	ATDALMTGY
CASSRRQGAMRETQYF	HSKKKCDEL
CASSFRDRGHYEQYF	TPRVTGGGAM
CAGRPRLAGGNNEQFF	RAKFKQLL
CASRGSGVYEQYF	IIKDYGKQM
CASSPSGQLETQYF	ATDALMTGY
CASSYSSGELFF	TPRVTGGGAM
CASSLGGDIQYF	KLVALGINAV
CASRWTGQLDEQFF	ATDALMTGY
CASTGWVTDTQYF	VSFIEFVGW
CASSYSTGTHLEQYF	NLVPMVATV
CASSYVTGTGSYGYTGF	NLVPMVATV
CASSLAGTQETQYF	KAFSPEVIPMF
CASRPNLGGTTEAFF	TPRVTGGGAM
CASRPGQGGYEQYF	ISPRTLNAW
CASSSLQGNGQPQHF	YVLDHLIVV
CASGQGQETQYF	KLVALGINAV
CASRDTYEQYF	ATDALMTGY
CASSQETGSYEQYF	RPPIFIRRL
CASSGTHNEQFF	RPPIFIRRL
CASSPGPQRGGLETQYF	HSKKKCDEL
CASSLAPSYEQYF	RAKFKQLL
CANSQPGGIEQFF	EPLPQGQLTAY
CASSPLEAEAKNIQYF	ATDALMTGY
CASSFSLGAAGELFF	YVLDHLIVV
CSARGWVSNNRETQYF	KAFSPEVIPMF
CASNRESAYTF	HPVGEADYFEY
CASSEAVISYNEQFF	ATDALMTGY
CAISESSSGSNEQFF	ATDALMTGY
CSARTEGAEAFF	CVNGSCFTV
CASSIGGWRAEATNEKLFF	ATDALMTGY
CASSFQTGASYGYTF	NLVPMVATV
CASSLFGSPEQPQHF	FPRPWLHGL
CASSLVGGAGEQFF	ATDALMTGY
CASSLWSAGVHNEQFF	KLVALGINAV
CASSIGHNTGELFF	KLVALGINAV
CASSFSSGTTDTQYF	GLCTLVAML
CASSPTTGTGHYGYTF	NLVPMVATV
CSVVLAPVQEQFF	YVLDHLIVV
CASSLRQGINTGELFF	TPRVTGGGAM
CASSPSHGPNEKLFF	IPSINVHHY
CASSLQGSNQPQHF	YVLDHLIVV
CASRGGSGELFF	KAFSPEVIPMF
CASSLVSSGANVLTF	RAKFKQLL
CASKMRGDVYEQYF	RAKFKQLL
CASSVAGSATGELFF	NLVPMVATV
CASSMGGNPEQYF	KLVALGINAV
CASSFVDSLSNQPQHF	KRWIILGLNK
CASSFSGSLTTEAFF	RAKFKQLL
CASSLLGQLYEQYF	ATDALMTGY
CASSSSWADTQYF	KLVALGINAV
CAIRPFLGQDDNYGYTF	FLKEKGGL
CASSSQENTEAFF	KRWIILGLNK
CSAIPSYLSIGEQFF	YVLDHLIVV
CASSQTLAGGGETQYF	YVLDHLIVV
CASSVAGGDEQYF	GLCTLVAML
CSGGQGEGEQFF	RAKFKQLL
CAWTETGLSGNTIYF	RPRGEVRFL
CSVEGGPGTAYNEQFF	IVTDFSVIK
CATSTGDSNQPQHF	EPLPQGQLTAY
CSAIDFPMGNEQFF	KLVALGINAV
CASRKWNGELFF	TAFTIPSI
CASKMGAEAFF	KLVALGINAV
CASSPRVVGSETQYF	ATDALMTGY
CASSFGGAGDTEAFF	KRWIILGLNK
CASREKGYDEQFF	HPVGEADYFEY
CASSLPPGGGVYGYTF	TPGPGVRYPL
CAISDPSGSSYNEQFF	RPRGEVRFL
CASSQVRGRGEQYF	RAKFKQLL
CSVGSGEDNEQFF	RAKFKQLL
CASNQETQYF	FLRGRAYGL
CASSLLGGGGEAFF	KRWIIMGLNK
CASEAGTVNTNTQYF	ATDALMTGY
CASSYEPGQVSHYSNQPQHF	FLKEKGGL
CSVEERVRGGEQYF	TPRVTGGGAM
CASSPVAGAPHEQYF	NLVPMVATV
CATRGTVINTGELFF	ATDALMTGY
CASSWGPEAFF	FLRGRAYGL
CASSSLTGSGQPQHF	YVLDHLIVV
CASSLYGEQYF	KRWIIMGLNK
CAISEGAMGNQPQHF	ATDALMTGY
CASSIRRIDPYNEQFF	KLVALGINAV
CASSFTRQSPYNEQFF	HPKVSSEVHI
CATSEAASSWTGELFF	RPRGEVRFL
CASTLLGGAGYNEQFF	NLVPMVATV
CAWSGLSGSYNEQFF	YVLDHLIVV
CASSWAGGPRDEQYF	NLVPMVATV
CSAPVLPQETQYF	SLYNTVATL
CASSHLDSGLAVDTEAFF	FPRPWLHGL
CASTLGTKRF	KRWIIMGLNK
CATSSSWDLNQPQHF	NLVPMVATV
CASSLGDRAFRNIQYF	KAFSPEVIPMF
CASSQTGQLDEQYF	ATDALMTGY
CASSSTDTGANVLTF	ATDALMTGY
CAPRVHTGELFFGE	NLVPMVATV
CASSPVTGQGFYGYTF	NLVPMVATV
CASSEDQGLTATYEQYF	CVNGSCFTV
CASSQDRLTGGYTF	RPPIFIRRL
CASSATYGYTF	KAFSPEVIPMF
CASSLMGVRDTEAFF	RAKFKQLL
CASSIAGSAYEQYF	KLVALGINAV
CATSSRGGETQYF	GPGHKARVL
CASFRGHEQFF	NLVPMVATV
CASSFYDWNTEAFF	EPLPQGQLTAY
CATSRLDITPNSPLHF	GPGHKARVL
CASRPQGRDQPQHF	RPRGEVRFL
CATSDRTGRHEQYF	IPSINVHHY
CASSPYGIDEQYF	RAKFKQLL
CAIGTGTISTETQYF	ATDALMTGY
CASSRTDDTEAFF	RAKFKQLL
CASRPIGGAQETQYF	TPGPGVRYPL
CSASNQESYGYTF	YVLDHLIVV
CSVEDRHYEQYF	QVPLRPMTYK
CASSQLGPSAYEQYF	NLVPMVATV
CASSLHFEVEKLFF	YVLDHLIVV
CASSQGRLSAEAFF	KRWIILGLNK
CASREGQGGTEAFF	KRWIIMGLNK
CASSIGGTGGIPQHF	NLVPMVATV
CASSQAENTEAFF	CINGVCWTV
CASKGQGARDGYTF	IPSINVHHY
CASTGQGYGYTF	KAFSPEVIPMF
CASSPPGPTGRGWYDTF	RAKFKQLL
CASAQIGPYEQYF	EPLPQGQLTAY
CATSGEGQGGPYGYTF	KAFSPEVIPMF
CASSRFFPGQGDHAKNIQYF	FLRGRAYGL
CASSLLGGGYAYEQYF	RAKFKQLL
CSALRDNYNSPLHF	RPRGEVRFL
CASSSPRTGYNYGYTF	CVNGSCFTV
CASSLGLAGGEETQYF	ATDALMTGY
CASSYSRGAGNTIYF	QVPLRPMTYK
CASNPAGQLETQYF	ATDALMTGY
CASSARSGELFF	HPVGEADYFEY
CASSWGQGSNYGYTF	IVTDFSVIK
CASSLVGRGLDEQYF	KRWIIMGLNK
CSARVTSSDEQYF	KRWIILGLNK
CASRTLAGPNTGELFF	RPPIFIRRL
CASSPAPSASSYEQYF	KLVALGINAV
CASSDSYGYTF	KLVALGINAV
CSTGTGEGGTQYF	RAKFKQLL
CASSLSGQLDEQFF	ATDALMTGY
CASSQGPPGLAQETQYF	HSKKKCDEL
CASSSRDRGAYEQYF	TPRVTGGGAM
CASSFMQGDSPLHF	RAKFKQLL
CASSGGSYGYTF	KAFSPEVIPMF
CASSAASGTDTQYF	FLRGRAYGL
CASSQLGQSTDTQYF	KAFSPEVIPMF
CASSPDGELFF	VSFIEFVGW
CASSSLYGDTGELFF	NLVPMVATV
CASSPGQGGYEQYF	KAFSPEVIPMF
CASSQDRGPDTQYF	FPRPWLHGL
CASSYQTGAAYGYTF	NLVPMVATV
CASSLIGVSSYNEQFF	TPRVTGGGAM
CASSLVFGTAGGQQFF	TPQDLNTML
CSARDGTGNGYTF	GLCTLVAML
CASSLGEQPQHF	KRWIILGLNK
CQAGDTEAFF	KLVALGINAV
CSVGPGENGPQHF	RAKFKQLL
CASSLAFGTSGGEQYF	TPQDLNTML
CASRATMGGGTEAFF	YVLDHLIVV
CASSQDRYTGGYTF	RPPIFIRRL
CASSSFGPSNQPQHF	KRWIILGLNK
CASSPGVFGVTQYF	KRWIILGLNK
CASSLIASGGYNEQFF	RAKFKQLL
CASSLEAGVSYEQYF	RPPIFIRRL
CASSPYGQFYEQYFGP	NLVPMVATV
CASSLVGPPGELFF	LPPIVAKEI
CASSTSDTQYF	GLCTLVAML
CASGQKGLDTEAFF	TPRVTGGGAM
CAWVPGTGGTEAFF	NLVPMVATV
CASSLETGSYEQYF	RPPIFIRRL
CASGTGDSNQPQHF	EPLPQGQLTAY
CASSLGTSFRTDTQYF	YVLDHLIVV
CASTSGQLAPGELFF	GLCTLVAML
CSVTGGGRTYEQYF	GPGHKARVL
CASSASTSDYSYEQYF	KRWIIMGLNK
CASSRRGEGHNEQFF	TAFTIPSI
CASSYSGNTEAFF	TPRVTGGGAM
CASSHTGAEAFF	IPSINVHHY
CASSPFGTGPYEQYF	ATDALMTGY
CASSLDVGEQYF	KRWIILGLNK
CASRLPGGYNEQFF	EPLPQGQLTAY
CASSSTRTGDGQPQHF	RAKFKQLL
CASSLLGLAGVGELFF	CINGVCWTV
CASRPQGREETQYF	RPRGEVRFL
CASSVGEGFDIQYF	KAFSPEVIPMF
CASSDLTGTAYNEQFF	KRWIIMGLNK
CASSHSRGSGNTIYF	HSKKKCDEL
CASRPGQGSHEQFF	KRWIIMGLNK
CASSLVLSSPTYYEQYF	RAKFKQLL
CASSSTITGMGDSGNTIYF	TPQDLNTML
CSAFSGAAFVTDTQYF	NLVPMVATV
CASSLLGQYNSPLHF	RAKFKQLL
CASSQGPNLQETQYF	RAKFKQLL
CASSIGQAYEQYF	FLRGRAYGL
CSAKDRGAENTGELFF	RAKFKQLL
CASSLSSHYGYTF	ATDALMTGY
CASSLRGENRDDYEQYF	TPRVTGGGAM
CASRLTGEKQETQYF	RPRGEVRFL
CASSGSAGGVWDNEQFF	RAKFKQLL
CASSLVVAGGPMSEQFF	EPLPQGQLTAY
CATSDLQGVRGVNEQFF	TAFTIPSI
CASSLIGHSNQPQHF	SLYNTVATL
CASSPLTGTGVYGYTF	NLVPMVATV
CASSSTGGNTIYF	TAFTIPSI
CASSYSTGIGGGYTF	NLVPMVATV
CASSSVDRSSYEQYF	FPRPWLHGL
CASRLLGGGQETQYF	KRWIILGLNK
CATRDYEQYF	GPGHKARVL
CASSFGQAWETQYF	NLVPMVATV
CASSRRGRDDEKLFF	HSKKKCDEL
CASSLRRDSGPPSNQPQHF	KAFSPEVIPMF
CASSLLAGQETQYF	RAKFKQLL
CASSPTGAGNQPQHF	RAKFKQLL
CASSLWIQETQYF	RAKFKQLL
CASSYVIYEQYF	TPRVTGGGAM
CASSLTGGTYEQYF	RPPIFIRRL
CASSIPPSGEQFF	GPGHKARVL
CASSIDGAGNQPQHF	SLYNTVATL
CASSLVSGSPTGELFF	NLVPMVATV
CASSLMQGQGRNGYTF	ATDALMTGY
CASSLFSGPSQTQYF	FPRPWLHGL
CSVKGGFPYNEQFF	RAKFKQLL
CAGGTGETSPGELFF	GLCTLVAML
CASSGVGGTDTQYF	NLVPMVATV
CASQRDYTGELFF	YVLDHLIVV
CSAEIIAEAIYNEQFF	GLCTLVAML
CASMSRDLNTGELFF	ATDALMTGY
CASSVAETNTGELFF	ATDALMTGY
CSVREDSTNEKLFF	GLCTLVAML
CASSPSGYNNEQFF	GPGHKARVL
CASRDRQSHEQYF	LPPIVAKEI
CASSYGGTGPEGSSYEQYF	TPQDLNTML
CASSAETQYF	KLVALGINAV
CASSLGLENEQFF	GLCTLVAML
CASSSSFPGGGNEQFF	NLVPMVATV
CASSPMDLLDEQYF	KAFSPEVIPMF
CASSDQSQETQYF	TPRVTGGGAM
CASSTGDSNQPQHF	EPLPQGQLTAY
CASSFSGQGAATNEKLFF	RAKFKQLL
CASSVRTGELFF	KRWIILGLNK
CASSFTWTSGGTTDTQYF	NLVPMVATV
CASSPGTLKETQYF	NLVPMVATV
CASSGITSGEYTIYF	HPVGEADYFEY
CSQTNREYNEQFF	YVLDHLIVV
CASTREGLNTGELFF	GLCTLVAML
CASSFQGSNEKLFF	RAKFKQLL
CASSTGTSNTGELFF	ATDALMTGY
CASSATGLSVTDTQYF	RAKFKQLL
CASSLGPVEAFF	HPKVSSEVHI
CAISEEGIGNQPQHF	ATDALMTGY
CASRVGAGNTEAFF	TPRVTGGGAM
CASSLTLLGNNEQYF	RAKFKQLL
CASSYRVTEAF	TPGPGVRYPL
CATKRTGTDTQYF	RAKFKQLL
CAIRAGGDEQFF	HSKKKCDEL
CASSFDAEQFF	SLYNTVATL
CASSSAHYGYTF	NLVPMVATV
CASSSLGGAGTGELFF	NLVPMVATV
CSARPQGQTVALHF	KAFSPEVIPMF
CASAQGRGTEAFF	TAFTIPSI
CASSMIQGADTQYF	TPQDLNTML
CASSYQTGAGGYGYTGF	NLVPMVATV
CSARGGSVFYEQYF	KRWIIMGLNK
CASSQGSYEQYF	KLVALGINAV
CASSFRLAVKNEQFF	RPPIFIRRL
CSANSRTGLGYTF	KLVALGINAV
CASSLTTGTGSYGYTF	NLVPMVATV
CASRPGQGSHEQYF	KRWIILGLNK
CASSLPDINTGELFF	ATDALMTGY
CASSEGNVAPGELFF	GLCTLVAML
CASSQEGGGGGQPQHF	TPQDLNTML
CASSSLRGSNQPQHF	YVLDHLIVV
CASSPHQADTQYF	NLVPMVATV
CSARGAGFSGANVLTF	YVLDHLIVV
CASSSGQAYEQYF	FLRGRAYGL
CASSSFLSSGETQYF	KAFSPEVIPMF
CASRPQGANEKLFF	RPRGEVRFL
CASSQGPPGTTRETQYF	HSKKKCDEL
CASSTGDHSNQPQHF	EPLPQGQLTAY
CSARSGVGNTIYF	GLCTLVAML
CASNPMGQGILFF	NLVPMVATV
CASSSASYGYTFGP	NLVPMVATV
CASSRYEQYF	ISPRTLNAW
CASRETYEQYF	ATDALMTGY
CSAQPGQENIQYF	IPSINVHHY
CASSPTTAYEQYF	IPSINVHHY
CASSLGPTVPGNTIYF	HPKVSSEVHI
CAISESSAGNQPQHF	ATDALMTGY
CASSAREGKLFF	HPVGEADYFEY
CASSQGQLNTQYF	KRWIILGLNK
CASRPTGQLETQYF	ATDALMTGY
CASSQETGSYEQFF	RAKFKQLL
CSARGWVSNNQETQYF	KRWIILGLNK
CATRIGWGTDTQYF	RPRGEVRFL
CATGRLAGETQYF	GPGHKARVL
CASSTPTSGVNTGELFF	RAKFKQLL
CASSLLGEKAYEQYF	RAKFKQLL
CASYPDRGRVNEQFF	QVPLRPMTYK
CSARDRAYGNTIYF	GLCTLVAML
CSVGQGGTNEKLFF	GLCTLVAML
CASSFDVEQFF	SLYNTVATL
CASSLALDEAFF	IPSINVHHY
CSVEDPDRPSYGYTF	KAFSPEVIPMF
CASSFLQVTEAFF	NLVPMVATV
CASSLGVSQETQYF	YVLDHLIVV
CASSIALSDNYGYTF	KLVALGINAV
CASSEVGQLETQYF	ATDALMTGY
CASSLDPEKGAFF	TPQDLNTML
CAWSINSAEAFF	KLVALGINAV
CASSYERGGLPKNIQYF	FLKEKGGL
CASSLGAGNYGYTF	TPRVTGGGAM
CASSAPAGELFF	HPVGEADYFEY
CASTAGQTTNFNEQFF	GLCTLVAML
CSVGQNSANTGELFF	GPGHKARVL
CASSYSSGKTDTQYF	GLCTLVAML
CASSFLPGQGSYYSNQPQHF	FLKEKGGL
CASSPGTLSAGELFF	GLCTLVAML
CASSSRSGELFF	HPVGEADYFEY
CAGSQDRLTGGYTF	RPPIFIRRL
CASRPGPVKNTGELFF	QVPLRPMTYK
CASSLMSGTDTQYF	KAFSPEVIPMF
CASSVWGTDTQYF	RPRGEVRFL
CASSRENSNQPQHF	IPSINVHHY
CASGSQGSTDTQYF	ATDALMTGY
CASRRGFHQPQHF	TPGPGVRYPL
CASSLTAPGIQPQHF	RAKFKQLL
CASSLSRQGTGELFF	TPGPGVRYPL
CASSLFVGGPGNEQFF	NLVPMVATV
CAIRTRTGESYTF	HSKKKCDEL
CAISATGAVTEAFF	RAKFKQLL
CSARTGVGNTIYF	GLCTLVAML
CASSSRQNTEAFF	KRWIILGLNK
CASSLASWGNEKLFF	RPRGEVRFL
CASSLSGQLDEQYF	ATDALMTGY
CATSDLGAGTSGTGELF	KAFSPEVIPMF
CASSYGSYEQYF	KLVALGINAV
CSAHRTENTEAFF	GLCTLVAML
CASSPLAGVGETQYF	RAKFKQLL
CASALEQGGYNEQFF	IIKDYGKQM
CASSPRDSKETQYF	KAFSPEVIPMF
CATSDLRGGKF	KAFSPEVIPMF
CASTAPATNTGELFF	ATDALMTGY
CASSQGSELMTGNTIYF	GLCTLVAML
CASSLLGQYNEQFF	FLKEKGGL
CASSSGATEAFF	KLVALGINAV
CASSQEMNRVVGNEQFF	FLKEKGGL
CASSFDKGYEQYF	HPKVSSEVHI
CASSPGQTNYGYTF	KAFSPEVIPMF
CASSLGTGHNEQFF	RAKFKQLL
CSVEASGGLFNEQFF	GLCTLVAML
CSVEDLGLAGATEQFF	GPGHKARVL
CASSSANYGYTFGS	NLVPMVATV
CASSYDLNEQYF	KRWIILGLNK
CASSSGTINTGELFF	ATDALMTGY
CASSLVGQLDEQYF	ATDALMTGY
